hwo: bup
bac: dwm eal nkh rrd mus
sey: yrr ieb
qrc: ofe kug rnd
hwk: lvv pan
ctl: fjq ppw hbs
qlq: aws eeg kfd hiw
qyh: cae uvz wvb
dhu: vgd
rjk: zem yqn vvl jqo
hpi: cib
eqc: eeo
act: ieb aox yrr
agm: cvv
zgt: out
jmd: gxx dac
ukx: yjx acp ydh isv
unr: vbr kig cep
mwe: nfw scr
lpu: fhg
lwe: jqo yqn vvl
wit: qhd
yte: aws eeg hiw
sto: eeo qqo mgs
zrm: jla ulf
wyw: uts gxy
gws: qzj you nzt
kab: out
qcv: qsa rqn
ojo: otr ttu
bwl: vod oeg fpi
pgc: uts
xwj: kyr
pqk: xge uia
iyy: rjz qvg kwi trn pbu
mkz: hiw eeg aws kfd
yqi: hnu prn
wvl: cpi ylf bog obg mwt abx okc buu slf tbp
ydh: cvv
nhu: zoq fux hpz ivp
mtg: out
pei: fgd
nkh: uum ewb jhr
vnm: lff adw zbl
hpz: tfz hyc wih yfp siq cwp gew ain lgo xbe iwr otn
etf: cvv rps
vvl: kjb fxp sey elr yyc
qzj: mwt hah xqv pcz slf kyq tbp okc qyh buu mnh
rwg: qrc
wyx: pri
pyp: out
svl: pri ggz kyr
vod: pgc dpo
dol: rps pbg cvv
uzu: pbg cvv rps
hvy: skh sep
hiw: svf zoc dla jak djy aga xwp eyh iyy qtz vwg ipl ian fsc lkf iff alx wry
rbv: xxc
pup: kdx quc bac
iff: sto byr eqc
fya: qcx ava hcn
fpi: pgc wyw
tbp: qib bpa vna hyv
jrd: ivn cib
otr: ikg xcm kxx bxd
aga: fqb mzl lxn
kwi: dvv fym qfu
koc: spl fnt enb xoo
tif: bup mcb olh
kjy: yts gay
gqc: oed
sbl: nnw zrm sut
erl: edk
rps: ues hjm mya igj oya fnv bwl kpk hvr uus xcl kjy erl yjw
fsj: whr tif zwr bic qwg fya
wry: otp
mtf: map
wia: aox yrr ieb
lzy: you
ymq: wpf ieb
rcy: joh
wdv: rhe
dxu: zoq hpz
aez: gwj wia rad ymq ity
nhy: ida gfi kyz
otx: nzt
qqb: kfd aws eeg hiw
dml: hbs ppw sok
gyc: cmr
cep: fvi mut otx
iqy: kol jwv mma
cmr: zqf qbv vvk
kpk: lym yts gay
rnd: aox
kug: ieb
gzb: out
gia: nzt wvl qzj
aox: geh hpi jlz oxw gyc zbu vve mzz kps hvy uvt zdh tls nly ijf lzl
xcl: mxt gma rcy
fun: lmr xyu
fqb: hcm
vsh: pcr ihb nvk
gwb: qgm
dzd: upg oyd jkb
ijq: hiw
otp: gwb qql xyu
joh: kfd eeg aws hiw
you: pww pcz mwt abx qyh xlt tbp
edh: tay
ues: fpi vod zfu oeg
uus: dkt
cwp: fkc
uhj: vgd
tbu: tin wpv
otn: pei fsp
jak: ycq eqc
svr: ubn lpl uut fsj oyk
qcx: xxc ukx ago
uam: scz sku
lkf: gwd fqb
hfq: lvv lss tbu pan edn
zmx: oyl qgu ufw
ugg: zfu oeg fpi
hcm: fux hpz zoq ivp
upy: gnn nnw sut
sku: hpz fux ivp
ukl: hiw aws kfd
emr: vvk
ulf: wpf aox
tyo: ttu
lpl: qwg ldf fya whr eke wpj qcv tea igt rrv ucb yfc hwo zwr tif
nzt: cpi pww kgv hah buu mwt kyq fkf
rjz: qfu dvv
ivn: fhg huq ole nox
skh: dac wyt gxx
gnn: ulf jla
xcm: ity ymq rad gwj
hnp: put lzv
ggf: wvl nzt
nvk: wdi fme giz
ofe: ieb yrr aox
qtz: qvg kwi rjz pbu
jhr: out
geh: kjt mnt jsz dmc unr
zoq: rwg yfp hsx tfz lgo ain gew kxb otn wem siq xbe cwp bna
zbu: wrz
slf: yqk uvi
sut: jla ulf
mus: jhr
aof: ykl zqk
tnl: ukl rvg
wqd: qzj
mtn: put uia lzv
cpg: ivp zoq fux
fsc: qvg kwi rjz trn
map: out
kxb: ufa fsp zbk fkc
nhv: ahm ifu
hcn: hot
hyc: qkf nmo zaa
ufw: cvv
vio: you qzj
lnj: yrr wpf aox ieb
vvk: you nzt qzj wvl
yjx: pbg cvv rps
yyc: wpf yrr
qfu: nhu
nnw: agr ulf
ain: jix ojo dmo kmv tyo
rrd: jhr
vwg: fun ptg
ycq: qqo
dwm: ewb
gkj: bve qdo ytf
zdh: jcj
eal: jhr
vrg: wdt
hbk: wit lhl
pqq: ufs pmm xve cgn
coh: ivp
qqo: ivp fux zoq
xbe: hbk lli cmt sfn
kxx: rad ity gwj
mgs: ivp zoq fux hpz
mek: knh vgd mqv
ian: sto ycq byr eqc
myh: vnm gfi
tea: asb xnh
emi: vgd mqv
ycy: pfy pti lbs nug
dmo: hum
wvb: zuo ycy qgp
vue: fjq ppw hbs
cmt: wit lhl czj
rna: gia
adw: pyp gzb
gqv: rps pbg
ijf: jcj
rxn: kug rnd fvs lnj
kdx: nkh dwm rrd mus
lmr: zze
scr: lss pan tbu edn
kyz: adw zbl qla lff dqu
gay: cqi lkk
pbu: uam
pti: jkb oyd
ufs: wyx xwj svl
jhg: nbs hag fft uhr
pcz: qib vna gcw bpa
fno: hpz zoq
pmm: xwj iza
tin: pbg
qbi: tuq
ptg: xyu
ivp: gew otn pgn hyc hsx wih wem
qql: zjv
enu: rps pbg cvv
fjq: kfd eeg hiw
ikg: ymq wia gwj
yvs: hfr nvk ihb
xlt: rrr
eyh: yvs eua vsh
ggz: eeg kfd hiw
yqk: byo myh nhy
cpi: fdp
edn: tin meu
mua: eew ifu ahm jly iqy
fvi: nzt wvl qzj
upe: krh
okf: mia
eeo: fux zoq ivp
bna: ufa fsp zbk
bxd: ymq rad wia
xqv: iaq
fsp: mky sbl upy
qgp: pti lbs dzd pfy
ipl: ycq eqc sto
sep: wyt
oxw: cib
mzl: cpg fno coh
ugd: oyl
jwv: map vqe
kwr: act bmk
bog: wvb cae uvz
lkk: jls fnt
nfw: edn
ill: enu ver
wrz: gia
arc: ivn lpu
qsx: out
fxk: gwb
gma: ukl joh
ocy: pbg rps
jyk: mcb
xge: wpr jja
uys: jhg prn
jkb: qsx lhy
fft: mir qlq
bwp: eeg aws kfd hiw
wpr: kyk dol uzu etf
cko: qgu ufw
alx: ycq eqc
byo: kyz
qdo: ufs
gqn: kdx quc
fej: gay lym yts
idj: own gxy wkx
iaq: edc pup gqn fhm
cbq: out
spl: kfd
fxp: aox ieb
gyn: ifu eew iqy
dcr: vue dml
ylf: uvi fdp
mya: bve
suw: qbv
iza: pri
bve: cgn
eew: mtf mma
bic: pqk
jix: hum ttu
uvi: myh nhy utg byo
nbs: yte qlq
acp: rps
lsq: rhe fps oed
rvg: kfd eeg aws
wem: zaa qkf nmo
gby: vsh eua yvs blm
bmk: yrr wpf ieb
lvv: meu
jsz: qny vbr
ymu: vue ctl
hot: acp ydh yjx
mnh: cae
dac: gws vio dwq wqd
rhe: rft
vna: uhj
nly: unr dmc
bne: xqs
uia: wpr
pgz: iqy jly ahm ifu eew
wpf: oxw vve mzz zbu arc blp cbi hpi jlz lzl nly kps
buu: uvz
vve: emr
umx: asb rqn xnh
hnu: nbs
nmo: zct onk lwe
fmx: ymu ypu
wdi: ivp zoq fux
dzs: ptg otp fun
qgm: fux zoq ivp
uvz: ycy qgp
rft: ver enu mia
igj: ytf pqq
dqz: hwk hfq
qhd: aox ieb
clw: nhv mua tuq pgz
czj: bmk act
oij: nzt you
bup: cko zmx rwf ugd vrg
bpa: emi uhj mek
mia: rps cvv
edc: bac kdx
wyt: wqd
zct: zem yqn
svf: vsh yvs
qwg: rqv bne dqz fql mwe
ldf: hnp mtn
ttu: ikg bxd xcm kxx aez
djy: vsh eua yvs blm
zbk: sbl mky
dqu: pyp
agr: wpf yrr ieb
rqv: nfw hwk scr
zfu: wyw pgc bot
yrr: bjn hvy ijf nly jrd tls zdh jlz cbi geh hpi zbu mzz vve arc
lhy: out
igt: gqc
qbv: wvl qzj nzt
edk: dcr ypu
iwr: qkf zaa
uhr: mir
pbg: kum ugg syz fej hjm uys gkj gim oya
oyl: rps pbg cvv
asb: xys agm
lss: tin wpv meu
zuo: lbs pti nug dzd
gcw: dhu uhj emi
vbr: otx fvi mut
zab: zgt
ida: lff dqu
kps: jmd sep
okc: hyv
xwh: kyk uzu dol etf
oeg: bot pgc idj wyw
blm: hfr
whr: pqk hnp
vlm: out
zjv: ivp
hah: dli rrr clw
hbs: kfd hiw
upg: cbq
nug: upg oyd
fym: sku scz
fme: ivp hpz fux zoq
sln: enu mia
kjb: yrr
fgd: gnn nnw zrm
mir: aws eeg
jlz: rna jcj sve
jly: mtf
gxy: qqb
gxx: wqd dwq vio gws
scz: zoq hpz fux
ahm: mtf jwv kol
ieb: cbi hpi uvt gyc oxw zdh mzz vve jrd blp
ver: rps
jja: gqv uzu kyk etf
mqv: ert
zqk: out
ifu: kol jwv mtf mma
cgb: fmx dkt edk
sve: ggf ive
yqn: sey
vgd: ihc ert zab aof
agk: prn
rtt: pup edc gqn fhm fdr
uut: eke edh igt yfc qcv tif
gfi: lff dqu adw zbl
rrr: nhv pgz gyn mua tuq
xyu: zjv zze
hfr: fme wdi dxu
eua: nvk ihb hfr pcr
ykl: out
knh: lsf ert aof ihc
gwd: coh cpg fno
mpv: rjk
tuq: eew iqy jly
kjt: kig
qyl: cgn xve pmm ufs
zem: fxp yyc elr sey
fql: xqs nfw hwk scr
abx: clw
eke: lsq gqc yvd tay
qib: mek uhj
qla: gzb
dvv: sku
qkf: rjk lwe onk zct
hvr: tnl mxt gma
lzv: jja
jqo: fxp
lhl: bmk act
aws: djy dzs dla zoc svf jak eyh xwp vwg ipl iyy qtz ian fsc alx wry lkf iff
bjn: sve jcj rna
isv: cvv
utg: kyz vnm gfi
kgv: gcw
uum: out
dpo: own wkx
ucb: dqz fql rqv bne
hyv: dhu mek emi
prn: nbs hag uhr fft
cgn: xwj svl iza
tay: fps rhe ngc
wdt: pbg rps
gim: oeg ewx
lym: koc
qvg: fym dvv
fkf: dli qbi clw rrr
yjw: qyl pqq
yvd: ngc oed fps
xve: iza svl xwj
kum: lym upe gay
xqs: lss tbu pan
wpv: cvv
cvv: dwo ues mya fnv yqi agk zol cgb kwn yjw syz xcl
rrv: qcx ava rbv
ywo: zqf vvk
zol: upe lym
wkx: bwp
enb: aws eeg
quc: eal nkh
oyd: qsx lhy
meu: cvv rps
jla: yrr ieb
cbi: sep
pcr: giz
ufa: upy fgd
xoo: kfd
yuu: out
xwp: fxk ptg otp
vqe: out
oyk: tif bic yfc ucb eke fya ldf igt rrv tea tkp
eeg: lkf iff gby zoc dla ipl dzs vwg
lsf: ykl
pgn: jix tyo dmo
elr: yrr wpf aox
put: xwh jja wpr
gew: pex rxn
pfy: upg
cqi: fnt enb xoo
fnt: hiw kfd aws
qgu: rps cvv
jcj: gia ggf ive
ubn: qwg tkp jyk fya ldf whr eke wpj bic qcv umx rrv igt edh tea yfc ucb zwr
own: mkz ijq bwp
dwq: wvl nzt
ava: ago ukx
hsx: hbk cmt
lzl: mnt kjt unr dmc
lgo: fkc pei fsp ufa
tkp: rqn asb qsa xnh
hjm: bve qdo ytf pqq
blp: suw ywo
xxc: isv acp yjx
fnv: hnu prn jhg
cib: huq fhg lzy nox
fps: sln rft
zbl: pyp kab
ert: vlm zgt ykl mtg
oya: edk
dla: gwd fqb lxn
rqn: xys agm
mcb: vrg rwf zmx cko
bot: gxy uts own
mut: qzj
qsa: ocy
lxn: fno coh
dwo: hnu
kyk: pbg
rad: aox yrr
xys: pbg rps
pww: qib vna hyv
xnh: xys ocy
ypu: vue dml ctl
oed: sln ill rft okf
yfp: pex qrc
trn: qfu dvv uam
krh: xoo
mky: nnw
lff: pyp gzb
yfc: dqz fql bne
fdp: nhy myh utg
mnt: cep vbr
gwj: wpf
mwt: vor rtt
wih: qrc rxn pex
cae: zuo qgp
giz: hpz fux ivp
zoc: fxk ptg fun
ole: qzj
pan: wpv meu
mma: map vqe yuu
fvs: wpf
zwr: wdv
mzz: skh jmd
tls: lpu ivn
fdr: quc
hag: qlq mir
fhg: wvl nzt you
olh: vrg ugd zmx
jls: kfd eeg aws
ihb: wdi fme giz
nkc: gnn
zze: zoq hpz fux ivp
yts: koc lkk cqi
kyr: eeg hiw
obg: rtt vor iaq
mxt: joh ukl rvg
kmv: otr ttu
tfz: ojo tyo kmv dmo
qny: mut oij
ngc: ill sln
rwf: qgu oyl ufw
ity: wpf
zqf: nzt wvl
kwn: tnl gma rcy
byr: mgs eeo
nox: qzj you nzt
dmc: vbr kig qny
ewb: out
ewx: bot pgc idj wyw
fux: kxb otn iwr siq wem xbe cwp pgn rwg yfp vkz tfz hsx hyc wih lgo ain gew
kol: vqe map
uvt: suw ywo emr
uts: mkz
ihc: mtg zqk zgt
ive: you qzj wvl
fkc: fgd nkc mky
ppw: aws
kfd: fsc ian alx wry iff qtz iyy vwg ipl eyh zoc svf jak aga dzs djy
lli: czj wit kwr
syz: dkt edk fmx
huq: qzj wvl nzt
pex: kug fvs lnj
dkt: ymu
pri: hiw kfd aws eeg
siq: lli hbk cmt
vkz: mpv
zaa: onk zct rjk
kyq: qbi rrr clw
ago: isv acp ydh
kig: otx
vor: pup edc gqn fhm
onk: yqn zem jqo
dli: nhv
sfn: kwr
fhm: kdx
hum: bxd xcm kxx ikg aez
sok: kfd hiw
lbs: upg oyd
ytf: xve
wpj: qcx
